         
          ##################
         #.....E............#
         #.................E#
   ########.................#
   #..................########
   #.p................#...E..#
   #......................e..#
   #....##...........########
   ##### #..................#
         #..................#
         #......######...E..#
         #...E..#    #......#
         #......#    #...e..#
         #......#    #......#
         #......#    #......#
         ########    ########