######################
#p.....#..........#..# 
#....................#                  
#.............e......#                  
#...#.....#..........#                  
########.....#########                  
#.e..E........E......#
#.E.......E........E.#                  
######################