######################
#p.....#..........#..# 
#....................#                  
#.............e......#                  
#...#.....#..........#                  
########.....#########                  
#.ee.E...E....E.....E#
#.Eee.....E........E.#                  
######################