#####################
#p.................E# 
#...................# 
######E.......#######                 
#...................#                  
#######.....E...#####                  
#.E.E.#.............#                  
#.E...#.............#
#.....#...E.....#.#.#
#.....#..........E..#
#...................#                  
#####################